jl	Hopi
avu	Karos
apd	2dehands
sj	HandyPick
amy	Отзовик
es	IQIYI
aly	Bebeclub
pm	AOL
tu	Lyft
mn	RRSA
jm	Mzadqatar
afb	Nebu
aub	Smitten
afg	Luck
uz	OffGamers
gu	Fora
aho	Upland
ky	SpatenOktoberfest
ajs	GetPlus
apn	Beboo
awg	Natura Avon
aar	Bearwww
yd	米画师Mihuashi
ayc	HungerStation
axv	AIA 友邦保險
atl	Watsons MY
aqb	Pinoy Peso
mk	LongHu
yg	CourseHero
si	Cita Previa
dn	Paxful
asi	OMODA
ez	GoerliFaucet
awm	Grosenia
di	Loanflix
om	Corona
nw	Ximalaya
mb	Yahoo
aqd	Pesohere
awf	Rothmans
uc	Tatneft
aec	AaHIRA Fashion
aiz	Brevo
anb	Abastece-aí
ng	FunPay
bw	Signal
lu	Crickpe
abr	Privy
aez	Shein
avi	Oye Turtle
aqf	Coze
tz	Лейка
re	Coinbase
qf	RedBook
gw	CallApp
avx	Zazzle
afc	Bunda
vj	Stormgain
qc	Праймериз 2020
kn	Verse
acj	TeriMeriChoice
ait	FeetFinder
axc	One World Connect
alo	Profee
awo	GreatDay SunFish
hq	Magicbricks
hs	Asda
fm	Touchance
hp	Meesho
aqt	Skrill
axu	Sipay
so	RummyWealth
avb	Tealive
anp	Blackcatcard
asv	Bilderlings
aeg	Flowwow
xo	Notifire
jr	Самокат
awh	NGCASH
bt	Alfa
nl	Myntra
lp	Algida
mx	SoulApp
avq	Wego
afw	Packeta
abd	BeBoo
aoq	JB Hi-Fi
ip	Burger King
tl	Truecaller
ix	Celcoin
ao	UU163
afs	Privalia
aog	Naukri
ame	Discover Hong Kong
atm	Yotta
aqh	Rayobyte
aey	Next
ew	Nike
ahx	Bitrue
aft	Neocrypto
anv	Shield
aci	Colombian Cupid
rb	Tick
of	Urent/jet/RuSharing
aat	TamTam
adl	EarnEasy
un	Humblebundle
amf	Acko
lk	PurePlatfrom
ci	RedBus
wn	GameArena
aei	Sharyat
dp	ProtonMail
aim	Firebase
aja	G2A
anj	Gemini
pu	Justdating
ayf	ITV
fo	MobiKwik
auv	ФК «Спартак»
bp	GoFundMe
rv	Kotak811
qm	RosaKhutor
avm	Instacart
ue	Onet
agk	Ipsos iSay
acx	VCollective
sp	HappyFresh
adm	FitCredit
aqw	Edvantum
nm	Thisshop
axx	Shopback
cx	Icrypex
aur	The Concert
qq	Tencent QQ
mj	Zalo
aml	Xbox
ast	THXapp
pv	Koshelek
asp	PhonePe
nt	Sravni
abq	Upwork
ej	MrQ
aff	C6 Bank
cz	Getmega
fg	IndianOil
avh	XM
abo	WEBDE
aka	LinkAja
ty	Окей
ul	Getir
fx	PGbonus
aum	Chipper Cash
wc	Craigslist
ava	E-CNY
hw	Alipay/Alibaba
qs	МирЗнакомств
alx	NutriClub
vm	OkCupid
ra	KeyPay
aky	GOMOFY
mo	Bumble
aw	Taikang
jw	Br777
aqc	Omne by FWD
atr	RIDE
pn	CoffeeLike
ga	Roposo
aqj	BigBasket
aer	PlayerAuctions
ahf	GAIL`s Bakery
anl	AttaPoll
ahp	Handyticket
vr	MotorkuX
ant	Cashew
zw	Quack
nn	Giftcloud
aux	Lightning AI
eu	LiveScore
bo	Wise
rn	Neftm
avw	Great Rewards
aqo	XREWARD
vx	HeyBox
afp	VFS GLOBAL
zj	ROBINHOOD
air	Cleartrip
qy	Zhihu
bq	Adani
auy	LivU
wl	YouGotaGift
aqz	BlazeTech
ahe	Bunq
ve	Dream11
qr	MEGA
arf	Enjoei
xf	LightChat
ep	Temu
ayi	Klook
adc	PlayOJO
yl	Yalla
acf	Winter Loan
ajc	Почта России
zr	Papara
vs	WinzoGame
mu	MyMusicTaste
io	ЗдравСити
ayk	Radquest
awr	KCEX
ajt	Город
ary	Presto
vp	Kwai
ch	Pocket52
aag	Pockit
abz	Дарить Легко
xt	Flipkart
pd	IFood
arx	Zinia
abf	Parimatch
df	Happn
tk	МВидео
wa	Whatsapp
ajk	Venteny
amj	M panels
aj	OneAset
aob	Anthropic
aoe	Sendwave
vc	Banqi
awn	DialMyCalls
uo	CafeBazaar
kp	HQ Trivia
afj	Laybuy
aoa	Hicard
be	СберМегаМаркет
arq	Adapundi
anf	ZoomInfo
aqn	CashMyPic
rx	Sheerid
fk	BLIBLI
ajb	Бери заряд
rm	Faberlic
cv	WashXpress
apj	Tinkoff VoiceKit
abc	Taptap Send
wy	Yami
akq	Blank Street
ok	Ok.ru
asu	Replit
adx	FirstCry
amr	Univest
amt	Moneyview
fy	Mylove
xg	FortunaSK
sg	OZON
au	Haraj
atd	BUKA
ur	MyDailyCash
rd	Lenta
zb	FreeNow
sf	SneakersnStuff
xi	InFund
iu	Bykea
ge	Paytm
lj	Santander
yo	Amasia
ux	Домовой
ib	Immowelt
ye	ZaleyCash
ki	99app
akj	Easycash
ama	WooPlus
rh	Ace2Three
awl	KitaBeli
la	Ssoidnet
ho	Cathay
ags	Abbott
aoz	ReclameAQUI
ape	Toutiao
ats	Fave
cj	Dotz
awi	ALY
api	KKTIX
avt	HuntTheMouse
aue	TicketOne
apw	Bankiros
yf	Citymobil
ts	PayPal
nz	Foodpanda
lf	TikTok/Douyin
kk	Idealista
cm	Prom
jz	Kaya
alq	Etsy
fu	Snapchat
dk	Pairs
apz	Wynk
yh	Hh
amh	MitID
asd	Hongguo 红果短剧
ws	Feeld
arv	DARKSIDE
avy	BV
ajf	Bananatok
ack	RegainRX
um	Belwest
lq	Potato
we	DrugVokrug
zq	IndiaPlays
cr	TenChat
aok	NETELLER
vt	Innomax
eb	Voltz
mc	Michat
lx	DewuPoison
ark	SageMaker Studio Lab
ari	Ring4
akk	Dagangan
yq	Mail.com
sq	KuCoinPlay
ajj	Rebtel
afo	KION
tg	Telegram
ha	My11Circle
adj	RummyCircle
aru	UNNI 강남언니
aoi	Cryptonow
uk	Airbnb
oc	DealShare
fi	Dundle
tj	DbrUA
fr	Dana
kb	Kufarby
uq	TopDetal
awk	Bereke Bank
atb	Movider
qa	MyFishka
pr	Trendyol
tc	Rambler
vi	Viber
tt	Ziglu
nb	Верный
ady	ТОКИО-CITY
xz	Paycell
asr	LA VOZ DEL PACIENTE
awb	FlixBus
ca	SuperS
acz	Claude
mz	Zolushka
vq	LadyMaria
avf	ONESIAM
aij	NEQUI
afv	PlayCKC
ani	Talabat
ahh	Cumbuca
ala	GetResponse
apb	EToro
gs	SamsungShop
zy	Nttgame
tw	Twitter
rz	EasyPay
oq	Vlife
anz	TopGun
ali	StockyDodo
te	EFood
lc	Subito
arc	CHECK24
alb	Guiche Web
ob	Onlinerby
bf	Keybase
afz	Klarna
dc	YikYak
yp	Payzapp
afy	Tuul
bb	LazyPay
pa	Gamekit
atk	ARCH
abs	Playerzpot
apf	Carrefour
qd	Taobao
awy	Kia
axb	TrueID
kc	Vinted
hl	Band
lw	MrGreen
cc	Quipp
amv	MeSeems
mh	Ашан
abp	D5BET
afm	Myboost
ll	888casino
auc	TotalPass
afd	Astra Otoshop
ld	Cashmine
aol	Paysera
ail	Смотрёшка
aek	EnerGO
agg	OneForma
ze	Shpock
atu	Сбер
kg	FreeChargeApp
ik	GuruBets
acr	QwikCilver
wg	Skout
jo	SticPay
ea	JamesDelivery
qo	Moneylion
vl	Ортека
ahd	Midnite
cd	SpotHit
bj	Вита экспресс
abk	GMX
wx	Apple
lb	Mailru Group
agy	Pixels
aht	MockGuru
ke	Эльдорадо
atw	DeepSeek
awj	HyperJar
ahv	Curve
apt	Airwallex
ko	AdaKami
agw	Adverts
kh	Bukalapak
adr	Boosty
ms	NovaPoshta
kj	YAPPY
kw	Foody
js	GolosZa
ake	DIKIDI
apk	Liberty
anm	CaltexGO
ajv	ShareParty
aun	Morinaga
arp	Continente
ay	Ruten
ck	BeReal
avv	ShopFarEast
xa	УлыбкаРадуги
bi	勇仕网络Ys4fun
auw	3Fun
xy	Depop
xj	White Calling
rg	Porbet
ro	PingCode
ahs	1and1
wz	FoxFord
agm	CMB
dq	IceCasino
bv	Metro
aab	BharatPe
akz	Panvel
zd	Zilch
avs	Wooppay
nq	Trip
aev	Inshallah
ata	Authy
aea	HungryPanda
jg	Grab
aus	PalawanPay
ahq	Bitget
ym	Youla.ru
ir	Chispa
ex	Linode
rk	Fotka
yy	Venmo
kd	Author24
jt	TurkiyePetrolleri
auz	Outlier
ajh	WAUG
jc	IVI
tn	LinkedIN
ahl	Maxim
aln	Remotasks
xe	GalaxyChat
sl	Robota.ua
aic	Whoscall
zt	Budweiser
auu	Четыре Лапы
agn	Велобайк
afr	Ultragaz
ams	GlowRoad
xh	OVO
nv	Naver
afi	Ame Digital
awz	PlayTime
axm	Não Me Perturbe
aow	Geekay
je	Nanovest
ayb	AsianDating
nf	Netflix
iq	Icq
up	Magnolia
ae	MyGLO
ass	CICIL
axr	Match
wm	99Speed
abv	PlayZone
bs	TradeUP
ako	Ryde
ln	Grofers
atp	Vonage
acc	LuckyLand Slots
ane	Supercell
bh	Uteka
agz	Jiva Petani
aih	Fups
at	Perfluence
adt	Willhaben
any	FastEarn
apy	Винлаб
eg	ContactSys
gi	Hotline
auq	WeLive
aoh	ЮMoney
xw	Taki
ql	CMTcuzdan
yi	Yemeksepeti
dt	Delivery Club
aav	Alchemy
qu	Agroinform
axq	Eventbrite
abl	Gpnbonus
go	Google,youtube,Gmail
eo	Sizeer
ahw	Zasilkovna
zk	Deliveroo
nj	FreshKarta
ajm	Gener8
aww	Pecunpay
atv	快手 Kuaishou
amx	TANK
aua	同程旅行 Tongcheng Travel
ads	GoChat
eq	Qoo10
pz	Lidl
akc	Paybis
axi	ProductLab
cy	РСА
ace	Tata Neu
ahg	Digivarsity Lurningo
vw	CoinField
asf	TextFree
aqv	Doorverse
aaw	Aya Bank
vf	Q12 Trivia
sr	Starbucks
aqr	SportEfir
jj	Aitu
aqa	Satori
qj	Whoosh
ya	Yandex
rc	Skype
abi	BytePlus
oy	CashFly
rf	Akudo
aco	AR Lens
agb	Smiles
vg	ShellBox
aiv	Remitly
awu	MosGram
aso	RL Solution
adn	Janganana
agx	MeiQFashion
sm	YoWin
gd	Surveytime
ayh	GB Wallet
ajz	MotionPay
uj	СhampionСasino
fz	KFC
ave	BizneX
aql	Xigua Video 西瓜视频
tm	Akulaku
iw	MyLavash
gq	Freelancer
st	Auchan
ajy	All Access
afe	GovBr
bc	GCash
fw	99acres
hu	Ukrnet
awp	Clapper
aex	Neon
amd	Smart
aqu	KBX
qi	23red
kv	Rush
br	Вкусно и Точка
aup	Botim
agu	Marlboro
akw	WINDS
amb	Vercel
abj	Serasa
rs	Lotus
avl	BRImo BRI
acm	Razer
iz	Global24
auk	STB Union
apu	LIC Games
aut	Миллионъ
acb	Spark Driver
de	Karusel
ajl	Av100pro
am	Amazon
sa	AGIBANK
adi	Zepto
zu	BigC
ak	Douyu
aq	Glovo
wt	IZI
nk	Gittigidiyor
agd	Grailed
xu	RecargaPay
nr	Tosla
aom	Monzo
xb	RummyOla
ot	Any other
jf	Likee
awa	NHN Cloud
atg	Mandi Bhav
lz	Things
atx	Winee3
alz	CasinoAndFriends
amk	GORDAN
wd	Столото
cl	UWIN
amg	SBI Card
tx	Bolt
ny	BitcoinBon
alu	BC Game
os	Dhani
pg	NRJ Music Awards
ui	RuTube
li	Baidu
mg	Magnit
wf	YandexGo
ahr	This Fate
qb	Payberry
mr	Fastmail
xq	MPL
avo	Twikey
ank	Garena
jy	Sorare
pj	Podeli
mw	Transfergo
fh	Lalamove
yz	Около
db	Ezbuy
asq	Warpcast
aoy	PLN Mobile
ado	Jasper Home Fashions
uv	BinBin
hm	Globus
qg	MoneyPay
af	TradeX
akt	Xworldwallet
alk	HUGESoft
gc	TradingView
adh	Frizza
ka	Shopee
dw	Divar
asm	PH777
vb	Кораблик
rl	InDriver
akm	LOTTE Mart
arj	E2zSTORE
awc	Nestle Baby
ahn	Рив Гош
ajo	CoffeeTea
aeu	TheFork
ss	Hezzl
avd	NCA888
qp	Максавит
fc	PharmEasy
abh	UOL Host
hx	AliExpress
aef	Long Drive Cars
axn	FastMoss
ade	Magicpin
asl	Familhao
ps	Zdorov
axo	Fanatics Live
qh	Oriflame
uh	Yubo
aws	7-Eleven
tf	Noon
ard	Maya
aym	Langit Musik
axd	STK
amz	ImmoScout24
aug	Магнит Маркет
co	Rediffmail
sh	Vkusvill
aty	FRND
amp	VerifyKit
du	AUBANK
alm	Muzz
yj	EWallet
xs	GroupMe
pp	Huya
az	CityBase
zp	Pinduoduo
arn	GFK
asw	ACSON
lr	Okta
dv	NoBroker
aem	AstraPay
akg	Book My Play
aik	ZUS Coffee
acn	Gringo
ai	CELEBe
ab	Alibaba
aor	OKX
gl	GlobalTel
aes	Золотое Яблоко
axg	Twin
arm	Cathay Pacific
me	Line msg
apo	Netmarble
alw	Vida
he	Mewt
mv	Fruitz
yn	Allegro
axt	GNJOY
apm	Index
sn	OLX
ji	Monobank
ma	Mail.ru
yw	Grindr
lg	MediBuddy
acs	Tata CLiQ Palette
su	LOCO
ju	Indomaret
aud	BkSMS
wp	163СOM
qw	Qiwi
avn	G42
le	E bike Gewinnspiel
ic	JoGo
awx	BusyFly
zo	Kaggle
jv	Consultant
hb	Twitch
awt	BlockDag
ih	TeenPattiStarpro
zm	OfferUp
ug	Fiqsy
ei	Taksheel
adw	Профи
ajp	AsiaMiles
bz	Blizzard
mf	Weidian
yu	Xiaomi
jb	Wing Money
wb	WeChat
alp	Mera Gaon
oo	LigaPro
lh	24betting
aiy	Nloto
da	MTS CashBack
axl	Viralmu
bm	MarketGuru
avj	SumUp
acp	BonusLink
jx	Swiggy
asz	Fonial
pw	SellMonitor
wv	AIS
adf	Punjab Timber Traders
aks	Hanya
ec	RummyCulture
ars	Bingo Plus
fs	Şikayet var
dg	Mercari
aig	Five Surveys
fl	RummyLoot
axz	WarPin
ns	Oldubil
kr	Eyecon
ii	CashKaro
apa	Exness
aou	IT Business Group
sv	Dostavista
ahj	Strato
gr	Astropay
act	Maxis
od	FWDMAX
ut	Энергобум
za	JDcom
vz	Hinge
tr	Paysend
og	Okko
apq	WePoker
aqi	Cairon Fashion
sk	Skroutz
axj	FIFGROUP MOBILE CUSTOMER
pq	CDkeys
zv	Digikala
uu	Wildberries
np	Siply
awd	Dunhill
asa	Habby
py	Monese
asb	YUEWEN 阅文集团
alg	Ankama
ain	SpaceWeb
apg	Damai
ub	Uber
en	Hermes
atj	Klin
ph	SnappFood
axp	ChargePoint
auj	High 5 Casino
zl	Airtel
ada	TRUTH SOCIAL
atf	Asharfi Design
sb	Lamoda
cu	炙热星河
lv	Megogo
xr	Tango
mq	GMNG
ara	Shareful
awe	MyGift
aaa	Nubank
cn	Fiverr
aax	Boyaa
mi	Zupee
arr	Линии Любви
gz	LYKA
ald	Nice88
kx	Vivo
axy	Alcon
cb	Bazos
uy	Meliuz
ayj	Realme
zf	OnTaxi
fb	Facebook
aps	Skelbiu
ta	Wink
aqy	SAPO
abg	PagBank
vh	Штолле
wu	PrivetMir
ks	Hirect
cw	PaddyPower
ou	Gabi
gk	AptekaRU
yx	JTExpress
ry	McDonalds
qz	Faceit
ar	Wondermart
anq	Hitnspin
agc	VIMpay
abt	ArenaPlus
no	Virgo
abw	SOKOLOV
akf	Ollis
ami	TEAMORU
ahc	START
nc	Payoneer
gv	Humta
avz	Getsbet
ud	Disney Hotstar
th	WestStein
avc	Bunches
axw	Allē
aos	Loloo
zn	Biedronka
kl	Kolesa.kz
ey	Miloan
mp	Winmasters
ajw	INDOBA
el	Bisu
aet	Greywoods
uf	Eneba
pb	SkyTV
ni	Gojek
ask	СВОЁ
agv	DoneDeal
apl	Sideline
ww	BIP
ba	Expressmoney
vo	Brand20ua
avg	Hooked Protocol
aqs	BetOnRed
ale	Lydia
aha	Angel One
amn	Constitutioner
afq	MagaLu
po	Premium.one
adq	Uzum
rp	Hamrahaval
alt	Segari
ajr	Boku
gb	YouStar
agj	Marktplaats
ig	Instagram
adz	Шоколадница
aeq	Godrej
km	Rozetka
il	IQOS
ahi	Daki
arl	Mainvest
agh	Getnet
ajg	Zaymigo
app	ClassPass
ahz	Кузбасс Онлайн
td	ChaingeFinance
agt	Uralairlines
aqp	Golden Plus GP
akd	Feels
akx	Sony LIV
amm	Punjab citizen
xm	Лэтуаль
aya	Gopay
afa	CDEK
qx	WorldRemit
ie	Bet365
zi	LoveLocal
jq	Paysafecard
cq	Mercado
axs	AIS PLAY
aif	Royal Canin
axk	BandinginAja
wo	Parkplus
wh	TanTan
hg	Switips
gx	Hepsiburadacom
axh	TAOVIP
ax	CrefisaMais
are	Seated
aa	Probo
pt	Bitaqaty
iv	Inboxlv
yv	IPLwin
adk	Khatabook
ajq	MyValue
age	Yetz Promo
ahm	Eureka
ann	Bradesco
atz	Air India
afu	ВсеИнструменты
aip	AfreecaTV
aof	Guzman y Gomez
ed	Gamer
akb	Gurmanika
dz	Dominos Pizza
ds	Discord
tp	IndiaGold
aeb	Shine Brand Seeds
als	Greggs
adp	Cabify
amu	Glassbox
ku	RoyalWin
ac	DoorDash
ajd	Bankera
ru	HOP
ij	Revolut
agr	Driffle
hj	Nykaa
ml	ApostaGanha
ael	Cloud Manager
zh	Zoho
rq	AptekiPlus
eh	Telegram 2.0
nh	AlloBank
aon	Binance
aay	JioMart
fv	Vidio
afh	MPokket
sw	NCsoft
gp	Ticketmaster
cs	AgriDevelop
anu	Edurators
qn	Blued
agp	Hdfcbank
gj	Carousell
asg	Asetku
pl	Perekrestok
aeo	Allofresh
aiq	Prime Opinion
alc	Facily
acu	CityMall
ad	Iti
aed	Booking.com
vn	Yaay
va	SportGully
att	BCD travel
arg	Gappx
oj	LoveRu
aov	Zanimaika
aeh	Аптека Апрель
alf	WEBULL
qt	MoneyСontrol
aew	Flip
pf	Pof.com
ais	DiDiFood
uw	Kirana
hr	JKF
akl	DOKU
md	Банки
afn	Roomster
oi	Tinder
fe	CliQQ
ff	AVON
cp	Uklon
aga	Publi24
aot	Diversity
yk	СпортМастер
ahy	Fliff
alj	Spotify
ee	Twilio
aje	CupidMedia
apr	Capital One
agi	Njuškalo
ah	EscapeFromTarkov
ajn	Gopuff
fd	Mamba
acy	Airtime
ne	Coindcx
aep	Slickcall
hc	MOMO
ano	Shopify
ja	Weverse
aid	Kwiff
dh	EBay
xk	DiDi
im	Imo
qk	Bit
aiw	Roblox
rj	Детский мир
ayl	WPK
aye	SmartSari
tq	Swvl
arz	Cineplex
aio	Prakerja
aqg	Publix
jp	Rbt
ti	Cryptocom
qe	GG
aby	ITMS
aji	МИГРАНТ СЕРВИС
avr	OJ
iy	FoodHub
ia	Socios
arw	ASA
acl	Swissmoney
wj	1хbet
aau	RockeTreach
akn	Chakra Rewards
zg	Setel
bg	MIXMART
dy	Zomato
xv	Wish
agq	Bajaj Finserv
it	CashApp
an	Adidas
ol	KazanExpress
ht	Bitso
cf	Irancell
aaq	Netease
ati	Kullut
ua	BlaBlaCar
us	IRCTC
vd	Betfair
av	Avito
atc	Lemo
aen	Madslots
bx	Dosi
amc	Fortune Slots
abe	Foodora
vy	Meta
px	Nifty
hn	Bonia
aaz	Ozan
acd	Cloud.ru
ft	Букмекерские
alv	TIER
axf	Hinance
aki	Tiketcom
afl	Vsesmart
ago	Servify
sz	Pivko24
abn	Bybit
abx	Kaching
ahk	БлинБери
wk	Mobile01
fj	Potato Chat
bn	Alfagift
aii	Hinge Dating
xp	MonetaRu
ly	Olacabs
asx	KIMGRES
afk	Chevron
oz	Poshmark
alr	Vson
anc	VARUS
acg	KoronaPay
kz	NimoTV
gf	GoogleVoice
anw	Premmia
ct	КухняНаРайоне
cg	Gemgala
alh	Lion Parcel
atq	PQHosting
yb	Система Город
ase	Collection Pot
vk	Vk.com
qv	Badoo
aqk	Richkart
ys	ZCity
asn	Boletomovil
adg	Yono777
agf	Meitu
hk	4Fun
dl	Lazada
ayd	NocNoc
abu	BPJSTK
amo	CoinFantasy
op	MIRATORG
kt	KakaoTalk
aee	Amway
kf	Weibo
aqm	Tala
adu	Seznam
axe	MocaMoca
arh	Super Ace
aca	Sunlight
sd	Dodopizza
avp	Ripio
adv	Cian
jn	CloudBet
gh	GyFTR
sc	Voggt
em	ZéDelivery
dm	Iwplay
nu	Stripe
ajx	Kemnaker RI
lm	FarPost
axa	Social Nature
awv	Wallapop
auf	PREMIER
rt	Hily
vv	Seosprint
aoj	Simply
yr	Miravia
ce	Mosru
aui	IDOLCHAMP
aox	Aukro
dr	OpenAI
agl	Betano
auo	Mycashbacks
apc	IGameBUY
arb	Las Vegas Casino
aba	Rappi
ov	Beget
rr	Wolt
tv	Flink
sy	Brahma
jh	PingPong
ang	TOMORO COFFEE
jd	GiraBank
xc	SynotTip
my	CAIXA
dd	CloudChat
adb	PoshVine
xl	Wmaraci
bd	X5ID
ate	GETAWARD
ana	Sicredi
abb	Coca-Cola
aap	Tiptapp
bu	MonobankIndia
ath	Samarth Diamond App
aph	Openbudget
gg	PagSmile
atn	Fawry
aqq	MPSTATS
ef	Nextdoor
auh	KeeTa 美团
mm	Microsoft
oh	MapleSEA
zs	Bilibili
dj	LUKOIL-AZS
akr	Voi
abm	Утконос
acw	YouDo
aju	Daya Auto
akp	Her
pc	Casino/bet/gambling
hy	Ininal
ash	Pinjam Yuk
akh	Prenagen Club
amw	Tise
xx	Joyride
aoo	Pegasus Airlines
oe	Codashop
asy	Fore Coffee
anh	Cadbury
aiu	GetNinjas
aul	Alignable
aix	Move It
aro	GGPoker
aas	XXGame
anx	InfinitePay
mt	Steam
bk	G2G
aej	Autoru
hz	Drom
bl	BIGO LIVE
acv	A23
acq	Astha Tea
dx	Powerkredite
aie	Фотострана
et	Clubhouse
afx	Gamesofa
ach	Плайт
ahb	Ubisoft
ayg	Leroy Merlin
lt	BitClout
aqx	XL-PEarl
hi	JungleeRummy
ls	Careem
ev	Picpay
lo	OPPO
gm	Mocospace
awq	Atlas Earth
kq	FotoCasa
gt	Gett
do	Leboncoin
xn	Familia
aqe	PeraMoo
zz	Dent
amq	FRESHOOS
xd	Tokopedia
wr	Walmart
zx	CommunityGaming
ri	BillMill
ox	Damejidlo
avk	Quoka
ato	Podrygka
fa	XadrezFeliz
ow	RegRu